课程目标：	培养学生对人工智能和智能科学的兴趣。培养智能科学知识创新和技术创新能力。提高学生智能软件的开发能力，为今后在相关领域的研究和应用奠定基础。
课程简介：	这门课程主要讲述人工智能（AI）的基本概念和相关的基本技术。课程的主要内容包括在介绍AI历史、研究领域和方法的基础上，重点学习人工智能领域主流的机器学习方法和工具软件（scikit、tensorflow），通过本课程的学习，使学生能理解人工智能的基本概念、主要研究方法和主要应用技术。
学习要求：	通过本课程的学习， 要求学生掌握人工智能的基本概念、基本原理、实用的开发方法和技术；了解人工智能研究与应用的最新动态和发展方向。
推荐材料及阅读文献：	1.	Aurélien Géron, Hands-On Machine Learning with Scikit-Learn and TensorFlow 2.	Toby Segaran, Programming Collective Intelligence 3.	Stuart Russell, Peter Norvig, Artificial Intelligence: A Modern Approach

教学周	章节名称	
第1周	AI简介	课程简介，课程考核及相关安排，教材简介等
第2周	机器学习简介	教材第二章
第3周	分类	教材第三章
第4周	模型训练	教材第四章
第5周	模型训练	教材第四章
第6周	支持向量机	教材第五章
第7周	决策树	教材第六章
第8周	随机森林	教材第七章
第9周	维约减	教材第八章
第10周	维约减	教材第八章
第11周	tensorflow简介	教材第九章
第12周	人工神经元网络	教材第十章
第13周	深度网络	教材第十一章
第14周	卷积神经元网络	教材第十三章
第15周	循环神经元网络	教材第十四章
第16周	强化学习	教材第十六章
第17周	综合实验总结	课堂研究讨论

课程网站 https://luckh2.github.io/aiclass
